receipt_no,completion_time,details,status,paid_in,withdrawn,balance
OHV045C6VC,2020-08-31 12:17:58,Customer Transfer of Funds Charge,Completed,0,-26.00,"1,777.62"
OHV045C6VC,2020-08-31 12:17:58,Customer Transfer to 0740339126 - Francisca mueni,Completed,0,"-1,500.00","1,803.62"
OHV843IMGU,2020-08-31 11:30:06,Customer Transfer to 0740339126 - Francisca mueni,Completed,0,-30.00,"3,303.62"
OHV943HWPN,2020-08-31 11:29:43,Customer Transfer to 0740339126 - Francisca mueni,Completed,0,"-1,000.00","3,333.62"
OHU63SZV36,2020-08-30 22:05:38,Customer Transfer to 254726547745 - KIPROTICH,Completed,0,-350.00,"4,333.62"
OHU73OLNTH,2020-08-30 19:49:37,Pay Bill Online to 244441 - SAFARICOM POSTPAID,Completed,0,-100.00,"4,683.62"
OHU63OJE1U,2020-08-30 19:48:18,OD Loan Repayment to 232323 - M-PESA Overdraw,Completed,0,-216.38,"4,783.62"
OHU13OJD9X,2020-08-30 19:48:16,Business Payment from 400201 - Co-operative Bank via,Completed,"5,000.00",0,"5,000.00"
OHU73A59I7,2020-08-30 14:11:59,OverDraft of Credit Party,Completed,214.23,0,330.00
OHU73A59I7,2020-08-30 14:11:59,Customer Transfer Fuliza M-Pesa to 254710677386 -,Completed,0,-330.00,0.00
OHU537N1FV,2020-08-30 13:00:15,Airtime Purchase,Completed,0,-50.00,115.77
OHU432HXX6,2020-08-30 10:20:50,Withdrawal Charge,Completed,0,-28.00,165.77
OHU432HXX6,2020-08-30 10:20:50,Customer Withdrawal At Agent Till 363430 - Kilimanjaros,Completed,0,"-2,000.00",193.77
OHU030GTBQ,2020-08-30 09:13:52,Merchant Payment to 901505 - SAFARI INVESTMENTS,Completed,0,"-1,500.00","2,193.77"
OHU1300JAT,2020-08-30 08:58:32,Withdrawal Charge,Completed,0,-28.00,"3,693.77"
OHU1300JAT,2020-08-30 08:58:32,Customer Withdrawal At Agent Till 229297 - Ever Comm,Completed,0,"-2,500.00","3,721.77"
OHU72YU8MB,2020-08-30 08:14:29,Customer Transfer to 254725866107 - PHILEMON,Completed,0,-530.00,"6,221.77"
OHT41ZS3JS,2020-08-29 09:39:58,Customer Transfer to 254713512100 - SARAH,Completed,0,-300.00,"6,751.77"
OHS314Q49T,2020-08-28 12:55:26,Airtime Purchase,Completed,0,-50.00,"7,051.77"
OHR8ZPZGZW,2020-08-27 22:14:18,Pay Bill Online to 244441 - SAFARICOM POSTPAID,Completed,0,-999.00,"7,101.77"
OHQ5YFMD5L,2020-08-26 19:06:31,Business Payment from 400201 - Co-operative Bank via,Completed,"5,000.00",0,"8,100.77"
OHQ5XWIDE5,2020-08-26 11:34:17,Withdrawal Charge,Completed,0,-28.00,"3,100.77"
OHQ5XWIDE5,2020-08-26 11:34:17,Customer Withdrawal At Agent Till 174844 - G And G,Completed,0,"-2,000.00","3,128.77"
OHQ3XWDH21,2020-08-26 11:30:31,M-Shwari Loan Disburse,Completed,"5,000.00",0,"5,128.77"
OHQ0XPYSXW,2020-08-26 08:15:34,Merchant Payment to 7217093 - HODAYA,Completed,0,-325.00,128.77
OHQ9XPUE93,2020-08-26 08:11:05,Withdrawal Charge,Completed,0,-28.00,453.77
OHQ9XPUE93,2020-08-26 08:11:05,Customer Withdrawal At Agent Till 233409 - Natsars Ltd,Completed,0,"-1,500.00",481.77
OHQ8XPSDJK,2020-08-26 08:08:55,Pay Bill to 200200 - Safaricom Post Paid Acc.,Completed,0,-500.00,"1,981.77"
OHP5XIB8IH,2020-08-25 20:02:53,Merchant Payment to 7214361 - SUSAN WAITHIRA,Completed,0,-350.00,"2,481.77"
OHP9XI4C25,2020-08-25 19:58:41,Merchant Payment to 139917 - Power Star Zimmerman,Completed,0,"-1,200.00","2,831.77"
OHP3XHFAWV,2020-08-25 19:44:38,Funds received from 254728700724 - TITUS LETTING,Completed,630.00,0,"4,031.77"
OHP5XHDW4L,2020-08-25 19:43:54,Funds received from 254729446308 - ANTHONY,Completed,378.00,0,"3,401.77"
OHP7XDUDQR,2020-08-25 18:43:01,Merchant Payment to 7208707 - KABSMART,Completed,0,"-1,380.00","3,023.77"
OHO5W43SWL,2020-08-24 14:42:17,Customer Transfer of Funds Charge,Completed,0,-26.00,"4,403.77"
OHO5W43SWL,2020-08-24 14:42:17,Customer Transfer to 0741197701 - FEDELMA WANZA,Completed,0,"-1,500.00","4,429.77"
OHN9VKBAT3,2020-08-23 20:26:34,Customer Transfer of Funds Charge,Completed,0,-56.00,"5,929.77"
OHN9VKBAT3,2020-08-23 20:26:34,Customer Transfer to 254729446308 - ANTHONY,Completed,0,"-3,050.00","5,985.77"
OHN1VHJH11,2020-08-23 19:27:44,Pay Bill Online to 244441 - SAFARICOM POSTPAID,Completed,0,-50.00,"9,035.77"
OHN5VFATTV,2020-08-23 18:47:18,Customer Transfer to 0757174687 - Valentine,Completed,0,-500.00,"9,085.77"
OHN8V5JLDE,2020-08-23 14:44:04,Merchant Payment to 952899 - WATER SHOP,Completed,0,-200.00,"9,585.77"
OHN1V2N0MD,2020-08-23 13:20:20,Merchant Payment to 120189 - POWERSTAR EXPRESS,Completed,0,-936.00,"9,785.77"
OHN9V2LBFJ,2020-08-23 13:19:02,Business Payment from 400201 - Co-operative Bank via,Completed,"10,000.00",0,"10,721.77"
OHN1V1D4NT,2020-08-23 12:41:31,Merchant Payment to 835857 - WA-DENNIS CEREAL,Completed,0,"-4,850.00",721.77
OHN5V0U80V,2020-08-23 12:25:26,Merchant Payment to 139917 - Power Star Zimmerman,Completed,0,-952.00,"5,571.77"
OHM6U2F2D4,2020-08-22 12:51:03,Withdrawal Charge,Completed,0,-50.00,"6,523.77"
OHM6U2F2D4,2020-08-22 12:51:03,Customer Withdrawal At Agent Till 168609 - Tosubeto,Completed,0,"-3,500.00","6,573.77"
OHM8U1XC8O,2020-08-22 12:37:51,Merchant Payment to 961670 - NEHKOM COLLECTION,Completed,0,"-1,000.00","10,073.77"
OHM1U0R9EV,2020-08-22 12:06:11,Pay Bill Charge,Completed,0,-34.00,"11,073.77"
OHM1U0R9EV,2020-08-22 12:06:11,Pay Bill to 824730 - SLEEKLADY COSMETICS LIMITED,Completed,0,"-1,295.00","11,107.77"
OHM0U0JS1W,2020-08-22 12:00:20,Business Payment from 400201 - Co-operative Bank via,Completed,"12,000.00",0,"12,402.77"
OHM9TZO4ST,2020-08-22 11:35:19,Withdrawal Charge,Completed,0,-28.00,402.77
OHM9TZO4ST,2020-08-22 11:35:19,Customer Withdrawal At Agent Till 384838 - Redgold,Completed,0,"-1,500.00",430.77
OHJ1R67ERP,2020-08-19 16:03:17,Customer Transfer to 254725950517 - BERNARD,Completed,0,-500.00,"1,930.77"
OHJ6R1CQSC,2020-08-19 13:54:40,Pay Bill Charge,Completed,0,-56.00,"2,430.77"
OHJ6R1CQSC,2020-08-19 13:54:40,Pay Bill Online to 540700 - Mhasibu SACCO Society,Completed,0,"-3,000.00","2,486.77"
OHI3QJVFLV,2020-08-18 21:12:21,Funds received from 254721249605 - KIPYEGON TITUS,Completed,"3,000.00",0,"5,486.77"
OHI5QH8XP1,2020-08-18 20:05:50,Airtime Purchase,Completed,0,-50.00,"2,486.77"
OHH6P87IOE,2020-08-17 17:13:32,Customer Transfer to 254729263633 - JANE TEGEREI,Completed,0,-200.00,"2,536.77"
OHG9O482FL,2020-08-16 15:06:26,Airtime Purchase,Completed,0,-20.00,"2,736.77"
OHG1NYNR31,2020-08-16 12:24:32,Withdrawal Charge,Completed,0,-67.00,"2,756.77"
OHG1NYNR31,2020-08-16 12:24:32,Customer Withdrawal At Agent Till 001179 - Safaricom,Completed,0,"-5,000.00","2,823.77"
OHF5NLQW9J,2020-08-15 20:56:01,Pay Bill Online to 244441 - SAFARICOM POSTPAID,Completed,0,-100.00,"7,823.77"
OHF7NCPUT3,2020-08-15 18:06:30,Withdrawal Charge,Completed,0,-27.00,"7,923.77"
OHF7NCPUT3,2020-08-15 18:06:30,Customer Withdrawal At Agent Till 2003782 - wajir,Completed,0,-500.00,"7,950.77"
OHF4NAYSZ4,2020-08-15 17:31:48,Withdrawal Charge,Completed,0,-28.00,"8,450.77"
OHF4NAYSZ4,2020-08-15 17:31:48,Customer Withdrawal At Agent Till 607612 - Empire,Completed,0,"-1,200.00","8,478.77"
OHF6N76OP6,2020-08-15 16:08:10,Merchant Payment Online to 331755 - CARREFOUR,Completed,0,-930.00,"9,678.77"
OHF2N64NQK,2020-08-15 15:42:23,Merchant Payment Online to 993119 - CARREFOUR,Completed,0,"-10,990.00","10,608.77"
OHF9N605U5,2020-08-15 15:39:20,Business Payment from 400201 - Co-operative Bank via,Completed,"20,000.00",0,"21,598.77"
OHE5MM3R8D,2020-08-14 22:05:54,Pay Bill Online to 200200 - Safaricom Post Paid Acc.,Completed,0,-500.00,"1,598.77"
OHD0LIRW7A,2020-08-13 20:54:55,Merchant Payment to 591535 -LYMOCOTT CHEMIST.,Completed,0,-210.00,"2,098.77"
OHD7KV2ZRH,2020-08-13 11:38:28,Customer Transfer of Funds Charge,Completed,0,-56.00,"2,308.77"
OHD7KV2ZRH,2020-08-13 11:38:28,Customer Transfer to 254729446308 - ANTHONY,Completed,0,"-2,528.00","2,364.77"
OHD7KUZ7QT,2020-08-13 11:35:32,Customer Transfer to 254711773727 - JONATHAN,Completed,0,-300.00,"4,892.77"
OHD5KQDIAN,2020-08-13 09:23:47,Customer Transfer of Funds Charge,Completed,0,-77.00,"5,192.77"
OHD5KQDIAN,2020-08-13 09:23:47,Customer Transfer to 254710677386 - KIPKURUI,Completed,0,"-6,284.00","5,269.77"
OHD0KQCEVC,2020-08-13 09:22:49,Business Payment from 400201 - Co-operative Bank via,Completed,"10,000.00",0,"11,553.77"
OHB0J7CT9O,2020-08-11 17:51:53,Customer Transfer to 254706032740 - Duncan Kiprono,Completed,0,-277.00,"1,553.77"
OHB6IVK6E2,2020-08-11 12:52:35,Customer Transfer to 254725950517 - BERNARD,Completed,0,-528.00,"1,830.77"
OHB1ILJPP3,2020-08-11 07:51:23,Pay Bill Charge,Completed,0,-56.00,"2,358.77"
OHB1ILJPP3,2020-08-11 07:51:23,Pay Bill to 4017474 - VIJIJI CONNECT LTDAcc.,Completed,0,"-3,100.00","2,414.77"
OHB9ILGPJZ,2020-08-11 07:47:25,Business Payment from 400201 - Co-operative Bank via,Completed,"5,000.00",0,"5,514.77"
OH91H319SN,2020-08-09 16:11:22,Merchant Payment Online to 592875 - CARREFOUR,Completed,0,"-2,692.00",514.77
OH90GX10B4,2020-08-09 13:25:55,Customer Transfer of Funds Charge,Completed,0,-41.00,"3,206.77"
OH90GX10B4,2020-08-09 13:25:55,Customer Transfer to 254726126629 - EVANS,Completed,0,"-1,528.00","3,247.77"
OH73EVI1CR,2020-08-07 13:54:21,Customer Transfer to 254759653599 - NGETICH DAVID,Completed,0,-528.00,"4,775.77"
OH60DW20T4,2020-08-06 15:23:35,Merchant Payment to 952899 - WATER SHOP,Completed,0,-200.00,"5,303.77"
OH50CKSDRU,2020-08-05 11:57:34,Customer Transfer of Funds Charge,Completed,0,-41.00,"5,503.77"
OH50CKSDRU,2020-08-05 11:57:34,Customer Transfer to 254702414581 - ESTHER,Completed,0,"-2,024.00","5,544.77"
OH53CKMG8P,2020-08-05 11:53:13,Merchant Payment to 289636 - SAMUL MERCHANTS -,Completed,0,"-4,060.00","7,568.77"
OH59CKDVML,2020-08-05 11:46:53,Pay Bill Online to 200200 - Safaricom Post Paid Acc.,Completed,0,-53.00,"11,628.77"
OH45BFASAB,2020-08-04 10:14:15,Customer Transfer to 254728076771 - ESTHER,Completed,0,-30.00,"11,681.77"
OH46BFAEB0,2020-08-04 10:13:54,Customer Transfer to 254728076771 - ESTHER,Completed,0,"-1,000.00","11,711.77"
OH30B1AAUI,2020-08-03 19:11:42,Airtime Purchase,Completed,0,-50.00,"12,711.77"
OH36AV4PQK,2020-08-03 17:11:31,Deposit of Funds at Agent Till 233409 - Natsars Ltd,Completed,"10,000.00",0,"12,761.77"
OH32ATKFNA,2020-08-03 16:35:35,Withdrawal Charge,Completed,0,-28.00,"2,761.77"
OH32ATKFNA,2020-08-03 16:35:35,Customer Withdrawal At Agent Till 645803 - JOYNET,Completed,0,"-1,000.00","2,789.77"
OH26A1YK9W,2020-08-02 19:09:03,Merchant Payment to 960657 - CARREFOUR TRM 24,Completed,0,"-1,437.00","3,789.77"
OH118UAXMD,2020-08-01 15:22:54,Customer Transfer of Funds Charge,Completed,0,-41.00,"5,226.77"
OH118UAXMD,2020-08-01 15:22:54,Customer Transfer to 254725950517 - BERNARD,Completed,0,"-1,530.00","5,267.77"
OH108P2DN4,2020-08-01 13:06:26,Merchant Payment to 147939 - Olive Restaurant,Completed,0,-700.00,"6,797.77"
OH188N6Q0A,2020-08-01 12:16:40,Withdrawal Charge,Completed,0,-28.00,"7,497.77"
OH188N6Q0A,2020-08-01 12:16:40,Customer Withdrawal At Agent Till 078821 - Takreem,Completed,0,"-2,500.00","7,525.77"
OH128N5P10,2020-08-01 12:15:54,Business Payment from 400201 - Co-operative Bank via,Completed,"10,000.00",0,"10,025.77"
OH118M5XCL,2020-08-01 11:49:16,Withdrawal Charge,Completed,0,-28.00,25.77
OH118M5XCL,2020-08-01 11:49:16,Customer Withdrawal At Agent Till 374738 - Dreamland,Completed,0,"-1,500.00",53.77
OH118GXFT5,2020-08-01 09:20:06,Withdrawal Charge,Completed,0,-50.00,"1,553.77"
OH118GXFT5,2020-08-01 09:20:06,Customer Withdrawal At Agent Till 231055 - Mahalla,Completed,0,"-3,500.00","1,603.77"
OGV47X13LY,2020-07-31 17:01:35,Withdrawal Charge,Completed,0,-112.00,"5,103.77"
OGV47X13LY,2020-07-31 17:01:35,Customer Withdrawal At Agent Till 233409 - Natsars Ltd,Completed,0,"-10,000.00","5,215.77"
OGV77WRTI9,2020-07-31 16:55:30,Merchant Payment to 835857 - WA-DENNIS CEREAL,Completed,0,"-1,350.00","15,215.77"
OGV67R5XQ8,2020-07-31 14:30:16,Pay Bill Charge,Completed,0,-23.00,"16,565.77"
OGV67R5XQ8,2020-07-31 14:30:16,Pay Bill Online to 888880 - KPLC PREPAID Acc.,Completed,0,-500.00,"16,588.77"
OGV47HG5HC,2020-07-31 10:08:25,Pay Bill Online to 244441 - SAFARICOM POSTPAID,Completed,0,-99.00,"17,088.77"
OGV47ATJHC,2020-07-31 00:42:55,Pay Bill Charge,Completed,0,-34.00,"17,187.77"
OGV47ATJHC,2020-07-31 00:42:55,Pay Bill Online to 714777 - NCBA LOOP Acc.,Completed,0,"-1,000.00","17,221.77"
OGU47A42L0,2020-07-30 22:51:33,Customer Transfer to 254710677386 - KIPKURUI,Completed,0,-527.00,"18,221.77"
OGU36IYGHR,2020-07-30 11:20:54,Customer Transfer of Funds Charge,Completed,0,-41.00,"18,748.77"
OGU36IYGHR,2020-07-30 11:20:54,Customer Transfer to 254721885480 - CHARLES,Completed,0,"-2,028.00","18,789.77"
OGT367TOIJ,2020-07-29 21:26:28,Airtime Purchase,Completed,0,-100.00,"20,817.77"
OGT867T9TI,2020-07-29 21:26:03,Airtime Purchase,Completed,0,-100.00,"20,917.77"
OGT867SVRE,2020-07-29 21:25:35,Airtime Purchase,Completed,0,-110.00,"21,017.77"
OGT667RPQU,2020-07-29 21:24:30,Airtime Purchase,Completed,0,-100.00,"21,127.77"
OGT7620HVB,2020-07-29 19:11:24,Customer Transfer to 0717830684 - LANGAT KIPKEMOI,Completed,0,-227.00,"21,227.77"
OGT45ZSHU4,2020-07-29 18:32:03,Merchant Payment to 791609 - CARREFOUR TRM 13,Completed,0,"-6,441.00","21,454.77"
OGT75YS4VZ,2020-07-29 18:13:04,Business Payment from 400201 - Co-operative Bank via,Completed,"25,000.00",0,"27,895.77"
OGT95YO105,2020-07-29 18:10:58,Pay Bill to 200200 - Safaricom Post Paid Acc.,Completed,0,"-1,000.00","2,895.77"
OGT55M933D,2020-07-29 13:05:48,Funds received from 254729446308 - ANTHONY,Completed,"1,030.00",0,"3,895.77"
OGT05M7JIO,2020-07-29 13:04:32,Funds received from 254729446308 - ANTHONY,Completed,"1,000.00",0,"2,865.77"
OGT95A4UL9,2020-07-29 01:22:13,Pay Bill Online to 244441 - SAFARICOM POSTPAID,Completed,0,-150.00,"1,865.77"
OGS25572GW,2020-07-28 20:03:10,Airtime Purchase,Completed,0,-50.00,"2,015.77"
OGS74ZO9SH,2020-07-28 18:16:34,Funds received from 254727899306 - BENARD KIPLIMO,Completed,30.00,0,"2,065.77"
OGS54ZLIEN,2020-07-28 18:15:01,Funds received from 254727899306 - BENARD KIPLIMO,Completed,"1,000.00",0,"2,035.77"
OGQ22X8YW8,2020-07-26 14:53:15,Customer Transfer of Funds Charge,Completed,0,-41.00,"1,035.77"
OGQ22X8YW8,2020-07-26 14:53:15,Customer Transfer to 254716635997 - MERCY,Completed,0,"-2,028.00","1,076.77"
OGQ12J6RUR,2020-07-26 01:35:31,Pay Utility Reversal by SAFARICOM POSTPAID,Completed,100.00,0,"3,104.77"
OGQ42J6FUW,2020-07-26 01:29:25,Pay Bill Online to 244441 - SAFARICOM POSTPAID,Completed,0,-100.00,"3,004.77"
OGP027CHZW,2020-07-25 18:00:11,Withdrawal Charge,Completed,0,-28.00,"3,104.77"
OGP027CHZW,2020-07-25 18:00:11,Customer Withdrawal At Agent Till 382850 - Loadman,Completed,0,"-2,500.00","3,132.77"
OGP91Z2BHX,2020-07-25 14:35:03,Pay Bill to 247247 - Equity Paybill Account Acc.,Completed,0,"-4,500.00","5,632.77"
OGP71Z001P,2020-07-25 14:33:17,Business Payment from 400201 - Co-operative Bank via,Completed,"10,000.00",0,"10,132.77"
OGP61XZB0Q,2020-07-25 14:04:56,Withdrawal Charge,Completed,0,-28.00,132.77
OGP61XZB0Q,2020-07-25 14:04:56,Customer Withdrawal At Agent Till 068227 - Stevenet,Completed,0,"-1,250.00",160.77
OGP41RFZTM,2020-07-25 10:57:59,Pay Bill Online to 244441 - SAFARICOM POSTPAID,Completed,0,-50.00,"1,410.77"
OGO814KWA6,2020-07-24 16:25:46,Customer Transfer of Funds Charge,Completed,0,-41.00,"1,460.77"
OGO814KWA6,2020-07-24 16:25:46,Customer Transfer to 254729446308 - ANTHONY,Completed,0,"-2,028.00","1,501.77"
OGN2YYHJ8U,2020-07-23 12:29:32,Customer Transfer of Funds Charge,Completed,0,-41.00,"3,529.77"
OGN2YYHJ8U,2020-07-23 12:29:32,Customer Transfer to 254792085136 - caroline ndinda,Completed,0,"-2,028.00","3,570.77"
OGN8YYFEOC,2020-07-23 12:27:47,M-Shwari Withdraw,Completed,"4,500.00",0,"5,598.77"
OGL6XCDTQI,2020-07-21 16:48:21,Customer Transfer to 254720563050 - PATRICIAH,Completed,0,-400.00,"1,098.77"
OGL2XBJZAE,2020-07-21 16:26:54,OD Loan Repayment to 232323 - M-PESA Overdraw,Completed,0,"-2,001.23","1,498.77"
OGL5XBJW91,2020-07-21 16:26:54,M-Shwari Withdraw,Completed,"3,500.00",0,"3,500.00"
OGL7XAXUJ7,2020-07-21 16:10:17,OverDraft of Credit Party,Completed,"1,981.41",0,"2,977.00"
OGL7XAXUJ7,2020-07-21 16:10:17,Merchant Payment Fuliza M-Pesa to 722791 -,Completed,0,"-2,977.00",0.00
OGL9X9XGNP,2020-07-21 15:42:07,Merchant Payment to 003673 - TBC THIKA RD MALL 2,Completed,0,-935.00,995.59
OGK7W6RU11,2020-07-20 12:47:37,Pay Bill Online to 200200 - Safaricom Post Paid Acc.,Completed,0,-500.00,"1,930.59"
OGI4UZDHL8,2020-07-18 20:36:45,Funds received from 254724775068 - CALEB,Completed,"2,050.00",0,"2,430.59"
OGI4U9IKES,2020-07-18 09:51:28,Merchant Payment to 673038 - KICHEWA TRADING,Completed,0,"-3,600.00",380.59
OGH9TDGYWZ,2020-07-17 10:53:44,Customer Transfer of Funds Charge,Completed,0,-77.00,"3,980.59"
OGH9TDGYWZ,2020-07-17 10:53:44,Customer Transfer to 254710677386 - KIPKURUI,Completed,0,"-6,284.00","4,057.59"
OGG0STI70S,2020-07-16 17:34:37,Airtime Purchase,Completed,0,-50.00,"10,341.59"
OGF9S5W7UR,2020-07-15 21:50:17,Funds received from 254727662350 - FLORAH ROTICH,Completed,"1,000.00",0,"10,391.59"
OGF1S5V46H,2020-07-15 21:48:47,Funds received from 254727662350 - FLORAH ROTICH,Completed,500.00,0,"9,391.59"
OGF4S5UQQE,2020-07-15 21:48:25,Funds received from 254727662350 - FLORAH ROTICH,Completed,"1,000.00",0,"8,891.59"
OGF2RSWKXM,2020-07-15 16:56:28,Pay Bill Charge,Completed,0,-56.00,"7,891.59"
OGF2RSWKXM,2020-07-15 16:56:28,Pay Bill to 540700 - Mhasibu SACCO Society Limited,Completed,0,"-3,000.00","7,947.59"
OGF8RKUSJO,2020-07-15 13:20:51,Funds received from 254724775068 - CALEB,Completed,"3,050.00",0,"10,947.59"
OGD1Q65AZJ,2020-07-13 20:07:00,Customer Transfer of Funds Charge,Completed,0,-41.00,"7,897.59"
OGD1Q65AZJ,2020-07-13 20:07:00,Customer Transfer to 254725866107 - PHILEMON,Completed,0,"-1,530.00","7,938.59"
OGC3OUX16J,2020-07-12 14:21:24,Merchant Payment to 139917 - Power Star Zimmerman,Completed,0,"-2,822.00","9,468.59"
OGC9OUH8WN,2020-07-12 14:08:13,Merchant Payment to 713349 - Edma Chemist Limited,Completed,0,-130.00,"12,290.59"
OGC7OU1Y9T,2020-07-12 13:55:23,Funds received from 254712713212 - FEDELMA,Completed,"7,500.00",0,"12,420.59"
OGB3O2R6JF,2020-07-11 16:32:51,Funds received from 254721249605 - KIPYEGON TITUS,Completed,"3,000.00",0,"4,920.59"
OGB7NV8L0J,2020-07-11 13:18:21,Merchant Payment to 993119 - CARREFOUR TRM 23,Completed,0,"-23,690.00","1,920.59"
OGB1NUVXIV,2020-07-11 13:08:40,Business Payment from 400201 - Co-operative Bank via,Completed,"25,000.00",0,"25,610.59"
OGB8NIKTX0,2020-07-11 00:07:42,Pay Bill Charge,Completed,0,-56.00,610.59
OGB8NIKTX0,2020-07-11 00:07:42,Pay Bill to 4017474 - VIJIJI CONNECT LTDAcc.,Completed,0,"-3,100.00",666.59
OGB4NIKQNE,2020-07-11 00:06:45,M-Shwari Withdraw,Completed,"3,000.00",0,"3,766.59"
OG81KWV0TT,2020-07-08 12:46:30,Customer Transfer of Funds Charge,Completed,0,-41.00,766.59
OG81KWV0TT,2020-07-08 12:46:30,Customer Transfer to 254725950517 - BERNARD,Completed,0,"-1,530.00",807.59
OG80KWUE2C,2020-07-08 12:45:57,M-Shwari Withdraw,Completed,"2,000.00",0,"2,337.59"
OG82KVG988,2020-07-08 12:06:55,Customer Transfer of Funds Charge,Completed,0,-26.00,337.59
OG82KVG988,2020-07-08 12:06:55,Customer Transfer to 254720050960 - CHELANGAT,Completed,0,"-1,028.00",363.59
OG72KBOQRY,2020-07-07 18:44:17,Customer Transfer of Funds Charge,Completed,0,-77.00,"1,391.59"
OG72KBOQRY,2020-07-07 18:44:17,Customer Transfer to 254724775068 - CALEB,Completed,0,"-5,067.00","1,468.59"
OG72KBM748,2020-07-07 18:43:04,M-Shwari Withdraw,Completed,"5,000.00",0,"6,535.59"
OG71JRKQIL,2020-07-07 10:16:27,M-Shwari Deposit,Completed,0,"-10,000.00","1,535.59"
OG65JBYH9Z,2020-07-06 18:29:06,Funds received from 0791913116 - Kipyegon,Completed,"10,000.00",0,"11,535.59"
OG64J6N1BE,2020-07-06 16:34:35,Customer Transfer to 254725950517 - BERNARD,Completed,0,-750.00,"1,535.59"
OG63J6K6GB,2020-07-06 16:32:48,M-Shwari Deposit,Completed,0,"-8,060.00","2,285.59"
OG69J4KJ25,2020-07-06 15:42:27,Funds received from 254723576355 - NOAH KIPTANUI,Completed,"2,030.00",0,"10,345.59"
OG51IKGM41,2020-07-05 21:10:40,Business Payment from 501901 - KCB 1 via API,Completed,"2,030.00",0,"8,315.59"
OG59IG9SUX,2020-07-05 19:26:03,Funds received from 254707182219 - David Henry,Completed,"4,000.00",0,"6,285.59"
OG40HAO1TE,2020-07-04 16:49:26,Withdrawal Charge,Completed,0,-10.00,"2,285.59"
OG40HAO1TE,2020-07-04 16:49:26,Customer Withdrawal At Agent Till 2018970 - Miraj Inv,Completed,0,-100.00,"2,295.59"
OG40GZRPOS,2020-07-04 12:18:11,Pay Bill Charge,Completed,0,-34.00,"2,395.59"
OG40GZRPOS,2020-07-04 12:18:11,Pay Bill to 824730 - SLEEKLADY COSMETICS LIMITED,Completed,0,"-1,425.00","2,429.59"
OG45GYQYXR,2020-07-04 11:51:01,Merchant Payment to 826537 - House of Leather-Hazina,Completed,0,"-1,900.00","3,854.59"
OG40GYQ770,2020-07-04 11:50:27,Business Payment from 400201 - Co-operative Bank via,Completed,"5,000.00",0,"5,754.59"
OG41GVWNZ9,2020-07-04 10:33:14,Withdrawal Charge,Completed,0,-50.00,754.59
OG41GVWNZ9,2020-07-04 10:33:14,Customer Withdrawal At Agent Till 381119 - Climbingstar,Completed,0,"-3,500.00",804.59
OG40GVVYGW,2020-07-04 10:32:38,Business Payment from 400201 - Co-operative Bank via,Completed,"3,000.00",0,"4,304.59"
OG30GG5G4S,2020-07-03 18:55:44,Customer Transfer of Funds Charge,Completed,0,-26.00,"1,304.59"
OG30GG5G4S,2020-07-03 18:55:44,Customer Transfer to 254711361054 - PATRICK MUUO,Completed,0,"-1,330.00","1,330.59"
OG39G17BVX,2020-07-03 13:06:10,Customer Transfer of Funds Charge,Completed,0,-56.00,"2,660.59"
OG39G17BVX,2020-07-03 13:06:10,Customer Transfer to 254707413155 - carolyne jepkirui,Completed,0,"-3,050.00","2,716.59"
OG22FG9VDI,2020-07-02 18:49:52,Pay Bill Charge,Completed,0,-23.00,"5,766.59"
OG22FG9VDI,2020-07-02 18:49:52,Pay Bill Online to 888880 - KPLC PREPAID Acc.,Completed,0,-500.00,"5,789.59"
OG27FB3HY7,2020-07-02 17:05:09,Merchant Payment to 835857 - WA-DENNIS CEREAL,Completed,0,-970.00,"6,289.59"
OG23FANYPL,2020-07-02 16:55:12,Merchant Payment to 139917 - Power Star Zimmerman,Completed,0,-655.00,"7,259.59"
OG22F2XEG2,2020-07-02 13:31:33,Pay Bill to 200200 - Safaricom Post Paid Acc.,Completed,0,"-1,000.00","7,914.59"
OG27F1HOJB,2020-07-02 12:51:28,Pay Bill Charge,Completed,0,-112.00,"8,914.59"
OG27F1HOJB,2020-07-02 12:51:28,Pay Bill Online to 540700 - Mhasibu SACCO Society,Completed,0,"-10,000.00","9,026.59"
OG20F1E62M,2020-07-02 12:48:45,Business Payment from 400201 - Co-operative Bank via,Completed,"10,000.00",0,"19,026.59"
OG12EKUO7M,2020-07-01 19:58:13,Airtime Purchase,Completed,0,-50.00,"9,026.59"
OG12EGMUBO,2020-07-01 18:43:54,Business Payment from 501901 - KCB 1 via API,Completed,"3,050.00",0,"9,076.59"
OG18ECMLHW,2020-07-01 17:27:04,Merchant Payment to 7003065 - TOGER CHEMIST,Completed,0,-100.00,"6,026.59"
OG19ECIQG3,2020-07-01 17:24:48,Withdrawal Charge,Completed,0,-112.00,"6,126.59"
OG19ECIQG3,2020-07-01 17:24:48,Customer Withdrawal At Agent Till 233409 - Natsars Ltd,Completed,0,"-10,000.00","6,238.59"
OG13EC6ZER,2020-07-01 17:17:50,Merchant Payment to 309590 - USAFI TWO BUTCHERY,Completed,0,-400.00,"16,238.59"
OG12EBPYGC,2020-07-01 17:07:39,Withdrawal Charge,Completed,0,-27.00,"16,638.59"
OG12EBPYGC,2020-07-01 17:07:39,Customer Withdrawal At Agent Till 414415 - Walts,Completed,0,-500.00,"16,665.59"
OG12E8ILD8,2020-07-01 15:49:48,Merchant Payment to 722791 - CARREFOUR TRM 30,Completed,0,"-6,060.00","17,165.59"
OG14E2KPFS,2020-07-01 13:08:34,Airtime Purchase,Completed,0,-100.00,"23,225.59"
OG15E2K6UX,2020-07-01 13:08:11,Airtime Purchase,Completed,0,-100.00,"23,325.59"
OG14E2JE78,2020-07-01 13:07:40,Airtime Purchase,Completed,0,-120.00,"23,425.59"
OG11DV6UTR,2020-07-01 09:36:23,Customer Transfer of Funds Charge,Completed,0,-56.00,"23,545.59"
OG11DV6UTR,2020-07-01 09:36:23,Customer Transfer to 254724775068 - CALEB,Completed,0,"-3,050.00","23,601.59"
OG13DV5XJ7,2020-07-01 09:35:33,Business Payment from 400201 - Co-operative Bank via,Completed,"25,000.00",0,"26,651.59"
OFU0DCS282,2020-06-30 17:41:17,Withdrawal Charge,Completed,0,-28.00,"1,651.59"
OFU0DCS282,2020-06-30 17:41:17,Customer Withdrawal At Agent Till 382850 - Loadman,Completed,0,"-2,000.00","1,679.59"
OFU0DCF4WE,2020-06-30 17:33:26,Funds received from 254712713212 - FEDELMA,Completed,30.00,0,"3,679.59"
OFU3DCDC7V,2020-06-30 17:32:23,Funds received from 254712713212 - FEDELMA,Completed,"1,000.00",0,"3,649.59"
OFU0DC7XAK,2020-06-30 17:29:08,Funds received from 254712713212 - FEDELMA,Completed,"1,000.00",0,"2,649.59"
OFT2CIFS2M,2020-06-29 18:56:05,Customer Transfer to 254712843885 - ALFRED,Completed,0,-50.00,"1,649.59"
OFT2CIF69C,2020-06-29 18:55:46,Customer Transfer to 254712843885 - ALFRED,Completed,0,"-1,000.00","1,699.59"
OFR6ALIPSE,2020-06-27 17:12:09,Merchant Payment to 993119 - CARREFOUR TRM 23,Completed,0,-746.00,"2,699.59"
OFR2AKBHPY,2020-06-27 16:43:57,Merchant Payment to 003673 - TBC THIKA RD MALL 2,Completed,0,"-1,105.00","3,445.59"
OFR6A0GZLY,2020-06-27 03:40:20,Pay Bill to 200200 - Safaricom Post Paid Acc.,Completed,0,-500.00,"4,550.59"
OFP68B2FNM,2020-06-25 10:34:01,Pay Bill Charge,Completed,0,-31.00,"5,050.59"
OFP68B2FNM,2020-06-25 10:34:01,Pay Bill to 572572 - Kenya Revenue Authority Acc.,Completed,0,-460.00,"5,081.59"
OFN372U42D,2020-06-23 19:52:27,Funds received from 254721249605 - KIPYEGON TITUS,Completed,"3,200.00",0,"5,541.59"
OFM0661EVM,2020-06-22 19:31:56,Withdrawal Charge,Completed,0,-27.00,"2,341.59"
OFM0661EVM,2020-06-22 19:31:56,Customer Withdrawal At Agent Till 620766 -,Completed,0,-500.00,"2,368.59"
OFM05XEZ8K,2020-06-22 16:21:02,Customer Transfer to 254720829094 - MARTIN,Completed,0,-177.00,"2,868.59"
OFM05XB9Z2,2020-06-22 16:18:20,OD Loan Repayment to 232323 - M-PESA Overdraw,Completed,0,"-1,954.41","3,045.59"
OFM55XB9YX,2020-06-22 16:18:19,Business Payment from 400201 - Co-operative Bank via,Completed,"5,000.00",0,"5,000.00"
OFM55WAUB7,2020-06-22 15:50:10,OverDraft of Credit Party,Completed,"1,935.05",0,56.00
OFM55WAUB7,2020-06-22 15:50:10,Customer Transfer of Funds Charge,Completed,0,-56.00,0.00
OFM55WAUB7,2020-06-22 15:50:10,Customer Transfer Fuliza M-Pesa to 254727016985 -,Completed,0,"-3,028.00","-1,879.05"
OFM55KB5BX,2020-06-22 09:48:06,Customer Transfer to 254710677386 - KIPKURUI,Completed,0,-250.00,"1,148.95"
OFL24RIPMQ,2020-06-21 11:26:56,Customer Transfer to 254728076771 - ESTHER,Completed,0,-530.00,"1,398.95"
OFK445IYHQ,2020-06-20 16:52:51,Customer Transfer of Funds Charge,Completed,0,-77.00,"1,928.95"
OFK445IYHQ,2020-06-20 16:52:51,Customer Transfer to 254710677386 - KIPKURUI,Completed,0,"-6,284.00","2,005.95"
OFI02K1B60,2020-06-18 20:38:37,Pay Bill Charge,Completed,0,-49.00,"8,289.95"
OFI02K1B60,2020-06-18 20:38:37,Pay Bill to 572572 - Kenya Revenue Authority Acc.,Completed,0,"-1,561.00","8,338.95"
OFI02AMF3I,2020-06-18 17:15:36,Customer Transfer to 254722935246 - GIDEON RONO,Completed,0,-530.00,"9,899.95"
OFI62ALT1S,2020-06-18 17:15:09,Customer Transfer to 254722935246 - GIDEON RONO,Completed,0,"-1,000.00","10,429.95"
OFI92ABHTF,2020-06-18 17:08:34,Business Payment from 400201 - Co-operative Bank via,Completed,"10,000.00",0,"11,429.95"
OFI52A8J8N,2020-06-18 17:06:38,Business Payment from 300600 - Equity Bulk Account,Completed,"1,000.00",0,"1,429.95"
OFI31XAWB1,2020-06-18 11:00:21,Pay Bill Online to 200200 - Safaricom Post Paid Acc.,Completed,0,-350.00,429.95
OFI31X9PEL,2020-06-18 10:59:26,M-Shwari Withdraw,Completed,500.00,0,779.95
OFH81HAGQ8,2020-06-17 18:45:42,Customer Transfer of Funds Charge,Completed,0,-41.00,279.95
OFH81HAGQ8,2020-06-17 18:45:42,Customer Transfer to 254728076771 - ESTHER,Completed,0,"-2,028.00",320.95
OFH4ZYGROI,2020-06-17 10:18:08,Pay Bill to 200200 - Safaricom Post Paid Acc.,Completed,0,-200.00,"2,348.95"
OFG3ZHO0CZ,2020-06-16 17:56:09,Customer Transfer of Funds Charge,Completed,0,-26.00,"2,548.95"
OFG3ZHO0CZ,2020-06-16 17:56:09,Customer Transfer to 254725866107 - PHILEMON,Completed,0,"-1,030.00","2,574.95"
OFG3ZBTOKT,2020-06-16 15:30:22,Customer Transfer to 254729629149 - ROBERT KIBET,Completed,0,-527.00,"3,604.95"
OFD5WUCOBV,2020-06-13 17:27:00,Customer Transfer of Funds Charge,Completed,0,-26.00,"4,131.95"
OFD5WUCOBV,2020-06-13 17:27:00,Customer Transfer to 254729446308 - ANTHONY,Completed,0,"-1,030.00","4,157.95"
OFC1W6UMAB,2020-06-12 20:57:26,Airtime Purchase,Completed,0,-50.00,"5,187.95"
OFB1ULPFEB,2020-06-11 09:43:19,Pay Bill Charge,Completed,0,-56.00,"5,237.95"
OFB1ULPFEB,2020-06-11 09:43:19,Pay Bill to 4017474 - VIJIJI CONNECT LTDAcc.,Completed,0,"-3,100.00","5,293.95"
OFA8TY991Q,2020-06-10 14:14:57,Merchant Payment to 139917 - Power Star Zimmerman,Completed,0,-909.00,"8,393.95"
OFA7TKWYI9,2020-06-10 00:25:20,Funds received from 254724775068 - CALEB,Completed,"2,550.00",0,"9,302.95"
OF97T2Z4OD,2020-06-09 14:35:22,Business Payment from 400201 - Co-operative Bank via,Completed,"6,000.00",0,"6,752.95"
OF97T1OWIN,2020-06-09 13:57:52,Pay Bill Charge,Completed,0,-85.00,752.95
OF97T1OWIN,2020-06-09 13:57:52,Pay Bill to 540700 - Mhasibu SACCO Society Limited,Completed,0,"-5,000.00",837.95
OF96T1N81E,2020-06-09 13:56:26,Business Payment from 400201 - Co-operative Bank via,Completed,"5,000.00",0,"5,837.95"
OF82SGN44M,2020-06-08 18:30:35,Customer Transfer of Funds Charge,Completed,0,-56.00,837.95
OF82SGN44M,2020-06-08 18:30:35,Customer Transfer to 254723845543 - KIPYEGON,Completed,0,"-2,528.00",893.95
OF78RJSIJ2,2020-06-07 17:57:40,Merchant Payment to 156270 - CUT WOTAZ,Completed,0,-180.00,"3,421.95"
OF76RDONSQ,2020-06-07 15:16:50,Customer Transfer to 254725866107 - PHILEMON,Completed,0,-530.00,"3,601.95"
OF65QDJUUR,2020-06-06 13:05:14,Pay Merchant Charge,Completed,0,-10.00,"4,131.95"
OF65QDJUUR,2020-06-06 13:05:14,Merchant Payment to 918186 - Total ABC PLACE,Completed,0,"-2,000.00","4,141.95"
OF61QDJ18J,2020-06-06 13:04:39,Business Payment from 400201 - Co-operative Bank via,Completed,"5,000.00",0,"6,141.95"
OF68Q4NJHO,2020-06-06 08:32:37,M-Shwari Lock Deposit,Completed,0,"-3,000.00","1,141.95"
OF53PLMSJD,2020-06-05 15:25:41,Customer Transfer of Funds Charge,Completed,0,-61.00,"4,141.95"
OF53PLMSJD,2020-06-05 15:25:41,Customer Transfer to 254723576355 - NOAH KIPTANUI,Completed,0,"-4,060.00","4,202.95"
OF57PJKPOT,2020-06-05 14:29:27,Customer Transfer of Funds Charge,Completed,0,-41.00,"8,262.95"
OF57PJKPOT,2020-06-05 14:29:27,Customer Transfer to 254714919110 - FRIDAH KIVUVA,Completed,0,"-2,024.00","8,303.95"
OF54PEZTW4,2020-06-05 12:18:55,Merchant Payment to 952899 - WATER SHOP,Completed,0,"-1,200.00","10,327.95"
OF57PA6D03,2020-06-05 09:55:24,Customer Transfer to 254728076771 - ESTHER,Completed,0,-530.00,"11,527.95"
OF55PA5M6H,2020-06-05 09:54:45,Customer Transfer to 254728076771 - ESTHER,Completed,0,"-1,000.00","12,057.95"
OF42OIQ7C0,2020-06-04 12:15:35,Airtime Purchase,Completed,0,-50.00,"13,057.95"
OF34O89BDE,2020-06-03 21:57:19,Customer Transfer to 254707413155 - carolyne jepkirui,Completed,0,-30.00,"13,107.95"
OF36O893M0,2020-06-03 21:56:50,Customer Transfer to 254707413155 - carolyne jepkirui,Completed,0,"-1,000.00","13,137.95"
OF38O88UXK,2020-06-03 21:56:16,Customer Transfer to 254712713212 - FEDELMA,Completed,0,"-1,000.00","14,137.95"
OF34NTFN4K,2020-06-03 15:27:22,Pay Bill to 200200 - Safaricom Post Paid Acc.,Completed,0,"-1,000.00","15,137.95"
OF36NTDJ3O,2020-06-03 15:25:42,Airtime Purchase,Completed,0,-100.00,"16,137.95"
OF34NTCYDS,2020-06-03 15:25:16,Airtime Purchase,Completed,0,-100.00,"16,237.95"
OF38NTBJTC,2020-06-03 15:24:15,Airtime Purchase,Completed,0,-110.00,"16,337.95"
OF32NT5M6M,2020-06-03 15:19:35,Customer Transfer to 254710677386 - KIPKURUI,Completed,0,-530.00,"16,447.95"
OF34NT50NO,2020-06-03 15:19:08,Customer Transfer to 254710677386 - KIPKURUI,Completed,0,"-1,000.00","16,977.95"
OF33NPI3GN,2020-06-03 13:34:39,Merchant Payment to 912652 - CARREFOUR TRM 12,Completed,0,"-7,438.00","17,977.95"
OF34NN0012,2020-06-03 12:19:46,Business Payment from 400201 - Co-operative Bank via,Completed,"25,000.00",0,"25,415.95"
OF23MLFH6R,2020-06-02 09:17:42,Customer Transfer to 254713052004 - ELKANAH,Completed,0,-350.00,415.95
OEV3LGQX0R,2020-05-31 18:44:42,Merchant Payment to 309590 - USAFI TWO BUTCHERY,Completed,0,-400.00,765.95
OEV1KU71DP,2020-05-31 03:11:07,Pay Bill to 200200 - Safaricom Post Paid Acc.,Completed,0,-300.00,"1,165.95"
OEU2KM5UK0,2020-05-30 18:35:00,Customer Transfer to 254728106797 - STEPHEN,Completed,0,-700.00,"1,465.95"
OEU5KM3GY5,2020-05-30 18:33:47,Business Payment from 400201 - Co-operative Bank via,Completed,"2,000.00",0,"2,165.95"
OEU0K7J6XA,2020-05-30 12:37:55,Customer Transfer to 254724675875 - JACKSON,Completed,0,-370.00,165.95
OEU7K5SWUH,2020-05-30 11:49:19,Withdrawal Charge,Completed,0,-28.00,535.95
OEU7K5SWUH,2020-05-30 11:49:19,Customer Withdrawal At Agent Till 156825 - Lexcon,Completed,0,"-1,500.00",563.95
OEU8K4SC1S,2020-05-30 11:19:57,Withdrawal Charge,Completed,0,-162.00,"2,063.95"
OEU8K4SC1S,2020-05-30 11:19:57,Customer Withdrawal At Agent Till 020601 - Raining,Completed,0,"-12,000.00","2,225.95"
OEU3K4PS9R,2020-05-30 11:17:53,Funds received from 254723576355 - NOAH KIPTANUI,Completed,"12,050.00",0,"14,225.95"
OEU5K3B047,2020-05-30 10:35:44,Customer Transfer to 254704073182 - ESTHER,Completed,0,-520.00,"2,175.95"
OEU4K2ZCD2,2020-05-30 10:25:44,Withdrawal Charge,Completed,0,-50.00,"2,695.95"
OEU4K2ZCD2,2020-05-30 10:25:44,Customer Withdrawal At Agent Till 755005 - Danfam,Completed,0,"-3,000.00","2,745.95"
OEU6K2VL0M,2020-05-30 10:22:23,Business Payment from 400201 - Co-operative Bank via,Completed,"5,000.00",0,"5,745.95"
OEU5K2U1B1,2020-05-30 10:21:00,Merchant Payment to 673038 - KICHEWA TRADING,Completed,0,-150.00,745.95
OES6IABAJS,2020-05-28 08:39:36,Customer Transfer to 254728076771 - ESTHER,Completed,0,-30.00,895.95
OES7IA9YHJ,2020-05-28 08:38:03,Customer Transfer to 254728076771 - ESTHER,Completed,0,"-1,000.00",925.95
OEQ0HAXM30,2020-05-26 20:21:32,Airtime Purchase,Completed,0,-50.00,"1,925.95"
OEP0G7M8RA,2020-05-25 16:12:59,Customer Transfer to 254798192105 - Stephen,Completed,0,-527.00,"1,975.95"
OEP6G69EQK,2020-05-25 15:31:59,Merchant Payment to 768256 - CARREFOUR TRM 06,Completed,0,"-1,651.00","2,502.95"
OEP8G5THME,2020-05-25 15:18:15,Customer Transfer to 254712843885 - ALFRED,Completed,0,"-1,000.00","4,153.95"
OEP8G5K0XE,2020-05-25 15:09:54,Business Payment from 400201 - Co-operative Bank via,Completed,"5,000.00",0,"5,153.95"
OEP9FXPJUR,2020-05-25 10:52:10,Airtime Purchase,Completed,0,-50.00,153.95
OEO5FOSG4X,2020-05-24 20:32:03,Airtime Purchase,Completed,0,-50.00,203.95
OEO5F4PY61,2020-05-24 10:34:56,Customer Transfer of Funds Charge,Completed,0,-77.00,253.95
OEO5F4PY61,2020-05-24 10:34:56,Customer Transfer to 254711403743 - Agnes Chepkurui,Completed,0,"-6,284.00",330.95
OEO8F4O57S,2020-05-24 10:33:03,Business Payment from 400201 - Co-operative Bank via,Completed,350.00,0,"6,614.95"
OEM5DIMCCN,2020-05-22 12:13:08,Customer Transfer to 254728076771 - ESTHER,Completed,0,-730.00,"6,264.95"
OEL1D8B92N,2020-05-21 21:56:46,Pay Bill Charge,Completed,0,-23.00,"6,994.95"
OEL1D8B92N,2020-05-21 21:56:46,Pay Bill Online to 888880 - KPLC PREPAID Acc.,Completed,0,-500.00,"7,017.95"
OEL6D8AF5K,2020-05-21 21:55:00,Business Payment from 400201 - Co-operative Bank via,Completed,"7,500.00",0,"7,517.95"
OEI3APQ5HP,2020-05-18 22:12:45,M-Shwari Deposit,Completed,0,"-2,000.00",17.95
OEI7AMW7MT,2020-05-18 19:56:46,Pay Bill Online to 244441 - SAFARICOM POSTPAID,Completed,0,-99.00,"2,017.95"
OEH69KLWN6,2020-05-17 16:48:48,Pay Bill Charge,Completed,0,-23.00,"2,116.95"
OEH69KLWN6,2020-05-17 16:48:48,Pay Bill to 220220 - PesaPal Acc. 0754317638,Completed,0,-200.00,"2,139.95"
OEH69KJY9K,2020-05-17 16:47:30,OD Loan Repayment to 232323 - M-PESA Overdraw,Completed,0,-160.05,"2,339.95"
OEH59KK31H,2020-05-17 16:47:30,Business Payment from 400201 - Co-operative Bank via,Completed,"2,500.00",0,"2,500.00"
OEH89KGA6W,2020-05-17 16:44:49,OverDraft of Credit Party,Completed,100.00,0,0.00
OEH89KGA6W,2020-05-17 16:44:49,Pay Bill Fuliza M-Pesa to 200200 - Safaricom Post Paid,Completed,0,-100.00,-100.00
OEG28DF0NS,2020-05-16 10:43:50,OverDraft of Credit Party,Completed,58.46,0,0.00
OEG28DF0NS,2020-05-16 10:43:50,Pay Bill Fuliza M-Pesa to 776611 - JAMII,Completed,0,-100.00,-58.46
OEE36RFUUF,2020-05-14 13:01:24,Pay Bill to 200200 - Safaricom Post Paid Acc.,Completed,0,-100.00,41.54
OED85S5XX4,2020-05-13 09:52:32,Pay Bill Charge,Completed,0,-2.00,141.54
OED85S5XX4,2020-05-13 09:52:32,Pay Bill to 220220 - PesaPal Acc. +254738720572,Completed,0,-50.00,143.54
OEC04YTTYU,2020-05-12 10:01:34,Customer Transfer to 254728076771 - ESTHER,Completed,0,-30.00,193.54
OEC04YTGRA,2020-05-12 10:01:11,Customer Transfer to 254728076771 - ESTHER,Completed,0,"-1,000.00",223.54
OEB14LPVFZ,2020-05-11 18:01:24,Customer Transfer of Funds Charge,Completed,0,-56.00,"1,223.54"
OEB14LPVFZ,2020-05-11 18:01:24,Customer Transfer to 254726917627 - FREDRICK,Completed,0,"-3,500.00","1,279.54"
OEB04B8V7E,2020-05-11 13:26:35,Customer Transfer of Funds Charge,Completed,0,-56.00,"4,779.54"
OEB04B8V7E,2020-05-11 13:26:35,Customer Transfer to 254702614917 - patrick ndungu,Completed,0,"-3,500.00","4,835.54"
OE982WSXDK,2020-05-09 17:23:52,Pay Bill Online to 244441 - SAFARICOM POSTPAID,Completed,0,-999.00,"8,335.54"
OE902UBTG2,2020-05-09 16:26:00,Withdrawal Charge,Completed,0,-28.00,"9,334.54"
OE902UBTG2,2020-05-09 16:26:00,Customer Withdrawal At Agent Till 298884 - Zetol Comm,Completed,0,"-1,000.00","9,362.54"
OE902UAXRI,2020-05-09 16:25:22,Business Payment from 400201 - Co-operative Bank via,Completed,"10,000.00",0,"10,362.54"
OE962PSURY,2020-05-09 14:20:38,Customer Transfer to 254725950517 - BERNARD,Completed,0,-30.00,362.54
OE922PRMHE,2020-05-09 14:19:44,Customer Transfer to 254725950517 - BERNARD,Completed,0,"-1,000.00",392.54
OE962PP8FG,2020-05-09 14:17:47,Customer Transfer to 254725950517 - BERNARD,Completed,0,"-1,000.00","1,392.54"
OE871OCW6H,2020-05-08 11:12:18,Customer Transfer to 254725866107 - PHILEMON,Completed,0,-150.00,"2,392.54"
OE861O8LCU,2020-05-08 11:08:30,Business Payment from 400201 - Co-operative Bank via,Completed,"2,500.00",0,"2,542.54"
OE851KTUMD,2020-05-08 09:15:59,Business Payment from 300600 - Equity Bulk Account,Completed,"1,030.00",0,"1,030.00"
OE861KTRZ4,2020-05-08 09:15:59,OD Loan Repayment to 232323 - M-PESA Overdraw,Completed,0,-987.46,42.54
OE61ZJ9LTD,2020-05-06 22:11:06,OverDraft of Credit Party,Completed,967.78,0,0.00
OE61ZJ9LTD,2020-05-06 22:11:06,Pay Bill Online Fuliza M-Pesa to 244441 - SAFARICOM,Completed,0,-999.00,-967.78
OE60YRFHU2,2020-05-06 09:09:04,Pay Bill to 200200 - Safaricom Post Paid Acc.,Completed,0,-350.00,31.22
OE58XTE5N4,2020-05-05 08:30:05,Customer Transfer of Funds Charge,Completed,0,-41.00,381.22
OE58XTE5N4,2020-05-05 08:30:05,Customer Transfer to 254725950517 - BERNARD,Completed,0,"-1,530.00",422.22
OE44XGATS8,2020-05-04 17:27:10,Customer Transfer to 254799355005 - NANCY OSATA,Completed,0,-550.00,"1,952.22"
OE44XBMKOY,2020-05-04 15:37:39,Pay Bill Online to 244441 - SAFARICOM POSTPAID,Completed,0,-999.00,"2,502.22"
OE49WX4OLP,2020-05-04 08:26:10,Pay Bill to 200200 - Safaricom Post Paid Acc.,Completed,0,-250.00,"3,501.22"
OE43WX2CXL,2020-05-04 08:23:29,Pay Bill Online to 200200 - Safaricom Post Paid Acc.,Completed,0,-892.00,"3,751.22"
OE39WJCTTN,2020-05-03 16:57:28,Pay Bill Charge,Completed,0,-23.00,"4,643.22"
OE39WJCTTN,2020-05-03 16:57:28,Pay Bill to 117197 - JOSMA HEALTH SERVICES,Completed,0,-800.00,"4,666.22"
OE38WFRRNY,2020-05-03 15:19:25,Customer Transfer to 254710677386 - KIPKURUI,Completed,0,-528.00,"5,466.22"
OE31WEUPN7,2020-05-03 14:50:52,Merchant Payment to 835857 - WA-DENNIS CEREAL,Completed,0,"-1,960.00","5,994.22"
OE26VJQSAC,2020-05-02 14:47:46,Merchant Payment to 791609 - CARREFOUR TRM 13,Completed,0,"-4,867.00","7,954.22"
OE22VIV5B6,2020-05-02 14:22:44,Business Payment from 400201 - Co-operative Bank via,Completed,"10,000.00",0,"12,821.22"
OE23V8PJNR,2020-05-02 09:02:06,Customer Transfer to 254711808246 - BEATRICE,Completed,0,-530.00,"2,821.22"
OE27V8P1TN,2020-05-02 09:01:28,Customer Transfer to 254711808246 - BEATRICE,Completed,0,"-1,000.00","3,351.22"
OE17V2FM7P,2020-05-01 21:00:53,Airtime Purchase,Completed,0,-125.00,"4,351.22"
OE11UX0GUR,2020-05-01 18:25:44,Merchant Payment to 7054735 - WONDER PRICE,Completed,0,-300.00,"4,476.22"
OE18UU9EZA,2020-05-01 17:29:09,Pay Bill Charge,Completed,0,-34.00,"4,776.22"
OE18UU9EZA,2020-05-01 17:29:09,Pay Bill to 117197 - JOSMA HEALTH SERVICES,Completed,0,"-2,350.00","4,810.22"
OE15UTLLYF,2020-05-01 17:14:35,Pay Bill Charge,Completed,0,-85.00,"7,160.22"
OE15UTLLYF,2020-05-01 17:14:35,Pay Bill to 117197 - JOSMA HEALTH SERVICES,Completed,0,"-5,450.00","7,245.22"
OE15UTKEBB,2020-05-01 17:13:55,Business Payment from 400201 - Co-operative Bank via,Completed,"10,000.00",0,"12,695.22"
OE16USBW1O,2020-05-01 16:45:18,Customer Transfer to 254728784138 - CHERUYOT,Completed,0,"-1,000.00","2,695.22"
OE12URUH8K,2020-05-01 16:33:44,Pay Bill Charge,Completed,0,-23.00,"3,695.22"
OE12URUH8K,2020-05-01 16:33:44,Pay Bill to 117197 - JOSMA HEALTH SERVICES,Completed,0,-600.00,"3,718.22"
OE18UPWKII,2020-05-01 15:43:40,Pay Bill Charge,Completed,0,-23.00,"4,318.22"
OE18UPWKII,2020-05-01 15:43:40,Pay Bill to 117197 - JOSMA HEALTH SERVICES,Completed,0,-500.00,"4,341.22"
OE19UP8YE3,2020-05-01 15:25:54,Withdrawal Charge,Completed,0,-28.00,"4,841.22"
OE19UP8YE3,2020-05-01 15:25:54,Customer Withdrawal At Agent Till 590001 - Cool Motors,Completed,0,"-1,000.00","4,869.22"
OE10UP83MM,2020-05-01 15:25:16,Business Payment from 400201 - Co-operative Bank via,Completed,"5,000.00",0,"5,869.22"
ODU8TXUA06,2020-04-30 17:42:50,Merchant Payment to 139917 - Power Star Zimmerman,Completed,0,-818.00,869.22
ODU2TTFF86,2020-04-30 16:04:52,Pay Bill to 200200 - Safaricom Post Paid Acc.,Completed,0,-100.00,"1,687.22"
ODU2TKAL34,2020-04-30 11:51:13,Withdrawal Charge,Completed,0,-27.00,"1,787.22"
ODU2TKAL34,2020-04-30 11:51:13,Customer Withdrawal At Agent Till 001202 - Kongoni,Completed,0,-350.00,"1,814.22"
ODT6TA4ILO,2020-04-29 22:29:54,Pay Bill Charge,Completed,0,-34.00,"2,164.22"
ODT6TA4ILO,2020-04-29 22:29:54,Pay Bill to 776611 - JAMII TELECOMMUNICATIONS,Completed,0,"-1,000.00","2,198.22"
ODT1SGRH5D,2020-04-29 00:42:16,Funds received from 254724775068 - CALEB,Completed,"1,050.00",0,"3,198.22"
ODT4SGQTAK,2020-04-29 00:31:59,M-Shwari Deposit,Completed,0,"-25,000.00","2,148.22"
ODS7SBYVNP,2020-04-28 19:09:06,Airtime Purchase,Completed,0,-100.00,"27,148.22"
ODS4SBXQ7E,2020-04-28 19:08:18,Airtime Purchase,Completed,0,-100.00,"27,248.22"
ODS8S921MQ,2020-04-28 18:04:43,Customer Transfer to 254724675875 - JACKSON,Completed,0,-300.00,"27,348.22"
ODS3RZNCZ1,2020-04-28 13:46:44,Withdrawal Charge,Completed,0,-28.00,"27,648.22"
ODS3RZNCZ1,2020-04-28 13:46:44,Customer Withdrawal At Agent Till 620766 -,Completed,0,"-1,000.00","27,676.22"
ODS2RZFP2S,2020-04-28 13:39:54,Pay Bill Online to 244441 - SAFARICOM POSTPAID,Completed,0,-999.00,"28,676.22"
ODR9R8PDG5,2020-04-27 14:11:15,Customer Transfer to 254725866107 - PHILEMON,Completed,0,-250.00,"29,675.22"
ODQ5QPU61H,2020-04-26 17:56:11,Merchant Payment to 309590 - USAFI TWO BUTCHERY,Completed,0,-300.00,"29,925.22"
ODQ2QMXI8K,2020-04-26 16:37:30,Funds received from 254708069547 - JUDITH,Completed,"30,000.00",0,"30,225.22"
ODP6PKWN06,2020-04-25 10:34:48,Customer Transfer to 0704212573 - Racheal Wachera,Completed,0,-200.00,225.22
ODO0P2L6VA,2020-04-24 15:27:25,Pay Bill Online to 244441 - SAFARICOM POSTPAID,Completed,0,-999.00,425.22
ODO5OQB9PF,2020-04-24 08:12:46,Pay Bill Charge,Completed,0,-23.00,"1,424.22"
ODO5OQB9PF,2020-04-24 08:12:46,Pay Bill to 776611 - JAMII TELECOMMUNICATIONS,Completed,0,-500.00,"1,447.22"
ODN8OL5ODQ,2020-04-23 19:45:06,Airtime Purchase,Completed,0,-30.00,"1,947.22"
ODN6OL4YI0,2020-04-23 19:44:32,OD Loan Repayment to 232323 - M-PESA Overdraw,Completed,0,-522.78,"1,977.22"
ODN1OL4Z25,2020-04-23 19:44:31,Business Payment from 400201 - Co-operative Bank via,Completed,"2,500.00",0,"2,500.00"
ODM0NV6I70,2020-04-22 20:30:55,OverDraft of Credit Party,Completed,517.60,0,0.00
ODM0NV6I70,2020-04-22 20:30:55,Pay Bill Online Fuliza M-Pesa to 244441 - SAFARICOM,Completed,0,-999.00,-517.60
ODM0NR839U,2020-04-22 18:35:28,Airtime Purchase,Completed,0,-50.00,481.40
ODM0NH4EHU,2020-04-22 14:11:47,Customer Transfer to 254724305484 - JACKSON,Completed,0,-100.00,531.40
ODM3NEF4QB,2020-04-22 12:43:20,Withdrawal Charge,Completed,0,-28.00,631.40
ODM3NEF4QB,2020-04-22 12:43:20,Customer Withdrawal At Agent Till 233409 - Natsars Ltd,Completed,0,"-1,500.00",659.40
ODL7N493TT,2020-04-21 21:06:29,Funds received from 254724775068 - CALEB,Completed,"1,000.00",0,"2,159.40"
ODL2N48K5C,2020-04-21 21:05:47,Funds received from 254724775068 - CALEB,Completed,"1,000.00",0,"1,159.40"
ODJ5LAIQTB,2020-04-19 15:51:21,Merchant Payment to 766636 - CARREFOUR TRM 04,Completed,0,"-1,962.00",159.40
ODJ2L4TH1U,2020-04-19 12:37:06,Pay Bill Online to 244441 - SAFARICOM POSTPAID,Completed,0,-999.00,"2,121.40"
ODJ0L4SQUG,2020-04-19 12:36:23,Business Payment from 400201 - Co-operative Bank via,Completed,"3,000.00",0,"3,120.40"
ODH8K4CLOW,2020-04-17 22:36:18,Pay Bill Online to 244441 - SAFARICOM POSTPAID,Completed,0,-999.00,120.40
ODG8JA4WT4,2020-04-16 21:25:05,Customer Transfer to 254725866107 - PHILEMON,Completed,0,-250.00,"1,119.40"
ODG5IWH6I9,2020-04-16 14:53:25,Pay Bill Charge,Completed,0,-34.00,"1,369.40"
ODG5IWH6I9,2020-04-16 14:53:25,Pay Bill to 776611 - JAMII TELECOMMUNICATIONS,Completed,0,"-1,000.00","1,403.40"
ODF5HXHWCJ,2020-04-15 11:29:53,Pay Bill Online to 244441 - SAFARICOM POSTPAID,Completed,0,-999.00,"2,403.40"
ODF4HSQO36,2020-04-15 08:30:06,Airtime Purchase,Completed,0,-100.00,"3,402.40"
ODD6GBC3A4,2020-04-13 09:31:03,Airtime Purchase,Completed,0,-100.00,"3,502.40"
ODC2G2OV72,2020-04-12 18:49:41,OD Loan Repayment to 232323 - M-PESA Overdraw,Completed,0,-397.60,"3,602.40"
ODC6G2OULI,2020-04-12 18:49:40,Business Payment from 400201 - Co-operative Bank via,Completed,"4,000.00",0,"4,000.00"
ODC1G26CH3,2020-04-12 18:37:40,OverDraft of Credit Party,Completed,300.00,0,0.00
ODC1G26CH3,2020-04-12 18:37:40,Customer Transfer Fuliza M-Pesa to 254724149892 -,Completed,0,-300.00,-300.00
ODC3FHI8GJ,2020-04-12 01:08:34,OverDraft of Credit Party,Completed,93.66,0,0.00
ODC3FHI8GJ,2020-04-12 01:08:34,Pay Bill Online Fuliza M-Pesa to 244441 - SAFARICOM,Completed,0,-999.00,-93.66
ODA9EJKMKJ,2020-04-10 19:23:51,Pay Bill Online to 244441 - SAFARICOM POSTPAID,Completed,0,-999.00,905.34
OD94DM1EIQ,2020-04-09 17:59:03,Customer Transfer to 254728076771 - ESTHER,Completed,0,-528.00,"1,904.34"
OD87CJNIEL,2020-04-08 14:25:04,Pay Bill Online to 244441 - SAFARICOM POSTPAID,Completed,0,-999.00,"2,432.34"
OD66ANQTMQ,2020-04-06 10:53:58,Pay Bill Online to 244441 - SAFARICOM POSTPAID,Completed,0,-999.00,"3,431.34"
OD64AJBMI4,2020-04-06 08:24:24,Customer Transfer of Funds Charge,Completed,0,-41.00,"4,430.34"
OD64AJBMI4,2020-04-06 08:24:24,Customer Transfer to 254720909690 - JANE MUTAI,Completed,0,"-1,528.00","4,471.34"
OD579ZMJRP,2020-04-05 13:50:35,Customer Transfer of Funds Charge,Completed,0,-41.00,"5,999.34"
OD579ZMJRP,2020-04-05 13:50:35,Customer Transfer to 254720302983 - ANNASTACIA,Completed,0,"-2,024.00","6,040.34"
OD599ZK1OF,2020-04-05 13:48:25,Customer Transfer of Funds Charge,Completed,0,-61.00,"8,064.34"
OD599ZK1OF,2020-04-05 13:48:25,Customer Transfer to 254707182219 - David Henry,Completed,0,"-4,060.00","8,125.34"
OD509WH9HQ,2020-04-05 12:11:35,Customer Transfer to 254725950517 - BERNARD,Completed,0,-50.00,"12,185.34"
OD509WGLN4,2020-04-05 12:11:00,Customer Transfer to 254725950517 - BERNARD,Completed,0,"-1,000.00","12,235.34"
OD4098Q6O2,2020-04-04 15:28:41,Customer Transfer of Funds Charge,Completed,0,-56.00,"13,235.34"
OD4098Q6O2,2020-04-04 15:28:41,Customer Transfer to 254724775068 - CALEB,Completed,0,"-3,050.00","13,291.34"
OD49951IOR,2020-04-04 13:43:37,Withdrawal Charge,Completed,0,-191.00,"16,341.34"
OD49951IOR,2020-04-04 13:43:37,Customer Withdrawal At Agent Till 183010 - Peace,Completed,0,"-25,000.00","16,532.34"
OD43950DV5,2020-04-04 13:42:45,Business Payment from 400201 - Co-operative Bank via,Completed,"25,000.00",0,"41,532.34"
OD4992JB21,2020-04-04 12:30:14,Customer Transfer to 254725950517 - BERNARD,Completed,0,-50.00,"16,532.34"
OD4392IWPH,2020-04-04 12:29:49,Customer Transfer to 254725950517 - BERNARD,Completed,0,"-1,000.00","16,582.34"
OD4992I7M1,2020-04-04 12:29:18,Customer Transfer to 254710677386 - KIPKURUI,Completed,0,-50.00,"17,582.34"
OD428ZGNL4,2020-04-04 10:58:52,Customer Transfer to 254727251756 - BERNARD,Completed,0,-327.00,"17,632.34"
OD318QW7GH,2020-04-03 21:03:40,Customer Transfer of Funds Charge,Completed,0,-97.00,"17,959.34"
OD318QW7GH,2020-04-03 21:03:40,Customer Transfer to 254712713212 - FEDELMA,Completed,0,"-11,000.00","18,056.34"
OD348QV4EG,2020-04-03 21:02:20,Customer Transfer to 254725866107 - PHILEMON,Completed,0,-527.00,"29,056.34"
OD398PZDPD,2020-04-03 20:26:18,Airtime Purchase,Completed,0,-100.00,"29,583.34"
OD338PTTD9,2020-04-03 20:20:42,Airtime Purchase,Completed,0,-105.00,"29,683.34"
OD368PSSYI,2020-04-03 20:19:44,Airtime Purchase,Completed,0,-100.00,"29,788.34"
OD378JAGT5,2020-04-03 17:47:43,Merchant Payment to 139917 - Power Star Zimmerman,Completed,0,-15.00,"29,888.34"
OD368J8SVC,2020-04-03 17:46:50,Merchant Payment to 139917 - Power Star Zimmerman,Completed,0,"-1,163.00","29,903.34"
OD308DK2FC,2020-04-03 15:32:25,Customer Transfer of Funds Charge,Completed,0,-56.00,"31,066.34"
OD308DK2FC,2020-04-03 15:32:25,Customer Transfer to 254725950517 - BERNARD,Completed,0,"-2,528.00","31,122.34"
OD338700P3,2020-04-03 12:26:15,Customer Transfer to 254712713212 - FEDELMA,Completed,0,"-1,000.00","33,650.34"
OD3386ZG0D,2020-04-03 12:25:48,Customer Transfer of Funds Charge,Completed,0,-61.00,"34,650.34"
OD3386ZG0D,2020-04-03 12:25:48,Customer Transfer to 254728076771 - ESTHER,Completed,0,"-4,067.00","34,711.34"
OD33805C85,2020-04-03 08:51:28,Pay Bill Online to 244441 - SAFARICOM POSTPAID,Completed,0,-999.00,"38,778.34"
OD317ZB5ET,2020-04-03 08:19:00,Pay Bill to 200200 - Safaricom Post Paid Acc.,Completed,0,"-1,000.00","39,777.34"
OD287NCSKI,2020-04-02 18:05:32,Merchant Payment to 835857 - WA-DENNIS CEREAL,Completed,0,"-1,060.00","40,777.34"
OD267CHI1Q,2020-04-02 13:19:20,Merchant Payment to 835857 - WA-DENNIS CEREAL,Completed,0,-420.00,"41,837.34"
OD287B7CEC,2020-04-02 12:39:21,Customer Transfer to 254728162089 - GEORGE BITA,Completed,0,-800.00,"42,257.34"
OD267B6LQA,2020-04-02 12:38:38,Customer Transfer to 254728162089 - GEORGE BITA,Completed,0,-828.00,"43,057.34"
OD2879PDRW,2020-04-02 11:52:23,Withdrawal Charge,Completed,0,-28.00,"43,885.34"
OD2879PDRW,2020-04-02 11:52:23,Customer Withdrawal At Agent Till 862036 - Efflyn Comm,Completed,0,"-2,500.00","43,913.34"
OD176ZV22B,2020-04-01 23:19:28,Customer Transfer of Funds Charge,Completed,0,-77.00,"46,413.34"
OD176ZV22B,2020-04-01 23:19:28,Customer Transfer to 254710677386 - KIPKURUI,Completed,0,"-6,284.00","46,490.34"
OD176W36LJ,2020-04-01 19:46:01,Pay Bill Charge,Completed,0,-85.00,"52,774.34"
OD176W36LJ,2020-04-01 19:46:01,Pay Bill Online to 711136 - CIM CREDIT KENYA,Completed,0,"-7,041.00","52,859.34"
OD156VXL45,2020-04-01 19:41:17,Pay Bill Charge,Completed,0,-45.00,"59,900.34"
OD156VXL45,2020-04-01 19:41:17,Pay Bill Online to 300067 - TIMIZA VIA ABSA Acc. FM-,Completed,0,"-2,546.00","59,945.34"
OD136SLJN1,2020-04-01 18:25:43,Pay Bill Charge,Completed,0,-23.00,"62,491.34"
OD136SLJN1,2020-04-01 18:25:43,Pay Bill Online to 888880 - KPLC PREPAID Acc.,Completed,0,-500.00,"62,514.34"
OD136RUNYX,2020-04-01 18:10:38,Merchant Payment to 952899 - WATER SHOP,Completed,0,-360.00,"63,014.34"
OD186RFBQI,2020-04-01 18:01:52,Merchant Payment to 591535 -LYMOCOTT CHEMIST.,Completed,0,-550.00,"63,374.34"
OD126QG0TK,2020-04-01 17:40:56,Merchant Payment to 722791 - CARREFOUR TRM 30,Completed,0,"-6,089.00","63,924.34"
OD146KFM8I,2020-04-01 15:06:14,Pay Bill Charge,Completed,0,-34.00,"70,013.34"
OD146KFM8I,2020-04-01 15:06:14,Pay Bill to 776611 - JAMII TELECOMMUNICATIONS,Completed,0,"-2,000.00","70,047.34"
OD106KBCNS,2020-04-01 15:02:42,OD Loan Repayment to 232323 - M-PESA Overdraw,Completed,0,"-2,952.66","72,047.34"
OD106KBDCI,2020-04-01 15:02:41,Business Payment from 400201 - Co-operative Bank via,Completed,"75,000.00",0,"75,000.00"
OCV35GH9L5,2020-03-31 09:35:08,OverDraft of Credit Party,Completed,999.00,0,0.00
OCV35GH9L5,2020-03-31 09:35:08,Pay Bill Online Fuliza M-Pesa to 244441 - SAFARICOM,Completed,0,-999.00,-999.00
OCU04XLCSC,2020-03-30 14:40:03,OverDraft of Credit Party,Completed,228.00,0,0.00
OCU04XLCSC,2020-03-30 14:40:03,Customer Transfer Fuliza M-Pesa to 254725866107 -,Completed,0,-228.00,-228.00
OCS63TVQ98,2020-03-28 21:08:53,OverDraft of Credit Party,Completed,523.00,0,23.00
OCS63TVQ98,2020-03-28 21:08:53,Pay Bill Charge,Completed,0,-23.00,0.00
OCS63TVQ98,2020-03-28 21:08:53,Pay Bill Fuliza M-Pesa to 776611 - JAMII,Completed,0,-500.00,-500.00
OCQ31KQSH1,2020-03-26 08:23:50,OverDraft of Credit Party,Completed,999.00,0,0.00
OCQ31KQSH1,2020-03-26 08:23:50,Pay Bill Online Fuliza M-Pesa to 244441 - SAFARICOM,Completed,0,-999.00,-999.00
OCO4Z4Z3EI,2020-03-24 12:00:09,OverDraft of Credit Party,Completed,60.56,0,0.00
OCO4Z4Z3EI,2020-03-24 12:00:09,Pay Bill Online Fuliza M-Pesa to 244441 - SAFARICOM,Completed,0,-999.00,-60.56
OCM3Y0D35X,2020-03-22 19:29:03,Merchant Payment to 139917 - Power Star Zimmerman,Completed,0,-322.00,938.44
OCM8XTYNNQ,2020-03-22 16:13:50,Pay Bill Charge,Completed,0,-23.00,"1,260.44"
OCM8XTYNNQ,2020-03-22 16:13:50,Pay Bill to 776611 - JAMII TELECOMMUNICATIONS,Completed,0,-500.00,"1,283.44"
OCM1XTXM95,2020-03-22 16:12:39,Customer Transfer to 254725866107 - PHILEMON,Completed,0,-28.00,"1,783.44"
OCM4XTXAUY,2020-03-22 16:12:23,Customer Transfer to 254725866107 - PHILEMON,Completed,0,"-1,000.00","1,811.44"
OCM0XTW4B6,2020-03-22 16:11:09,Customer Transfer to 254705295707 - kibet allan ruto,Completed,0,-110.00,"2,811.44"
OCM5XS0AAJ,2020-03-22 15:01:30,Customer Transfer to 254702507851 - KIBET ALLAN,Completed,0,-110.00,"2,921.44"
OCM2XNHAPY,2020-03-22 11:57:31,Pay Bill Online to 244441 - SAFARICOM POSTPAID,Completed,0,-999.00,"3,031.44"
OCK1W1HWIB,2020-03-20 11:37:48,Customer Transfer to 254706058836 - JUDY WANJIRU,Completed,0,-828.00,"4,030.44"
OCJ2VDNNDY,2020-03-19 15:23:42,Withdrawal Charge,Completed,0,-28.00,"4,858.44"
OCJ2VDNNDY,2020-03-19 15:23:42,Customer Withdrawal At Agent Till 351030 - Alyusra,Completed,0,-650.00,"4,886.44"
OCJ7VD4BBR,2020-03-19 15:05:25,Funds received from 254706056255 - Joseph Katuli,Completed,680.00,0,"5,536.44"
OCH7TUBM1T,2020-03-17 17:31:24,Customer Transfer to 254792085136 - caroline ndinda,Completed,0,-110.00,"4,856.44"
OCH4TL83HQ,2020-03-17 12:46:01,Pay Bill Online to 244441 - SAFARICOM POSTPAID,Completed,0,-999.00,"4,966.44"
OCH5TEAVL5,2020-03-17 08:53:33,OD Loan Repayment to 232323 - M-PESA Overdraw,Completed,0,"-2,334.56","5,965.44"
OCH1TEAPCL,2020-03-17 08:53:33,M-Shwari Loan Disburse,Completed,"8,300.00",0,"8,300.00"
OCG1T4FAL7,2020-03-16 19:24:39,OverDraft of Credit Party,Completed,511.00,0,11.00
OCG1T4FAL7,2020-03-16 19:24:39,Customer Transfer of Funds Charge,Completed,0,-11.00,0.00
OCG1T4FAL7,2020-03-16 19:24:39,Customer Transfer Fuliza M-Pesa to 254798963378 -,Completed,0,-500.00,-500.00
OCG1SS6VQ7,2020-03-16 13:49:12,OverDraft of Credit Party,Completed,542.00,0,15.00
OCG1SS6VQ7,2020-03-16 13:49:12,Customer Transfer of Funds Charge,Completed,0,-15.00,0.00
OCG1SS6VQ7,2020-03-16 13:49:12,Customer Transfer Fuliza M-Pesa to 254721365917 -,Completed,0,-527.00,-527.00
OCG4SPEB5Q,2020-03-16 12:21:09,OverDraft of Credit Party,Completed,542.00,0,15.00
OCG4SPEB5Q,2020-03-16 12:21:09,Customer Transfer of Funds Charge,Completed,0,-15.00,0.00
OCG4SPEB5Q,2020-03-16 12:21:09,Customer Transfer Fuliza M-Pesa to 254707413155 -,Completed,0,-527.00,-527.00
OCF1S5TSDX,2020-03-15 17:44:13,OverDraft of Credit Party,Completed,241.00,0,11.00
OCF1S5TSDX,2020-03-15 17:44:13,Customer Transfer of Funds Charge,Completed,0,-11.00,0.00
OCF1S5TSDX,2020-03-15 17:44:13,Customer Transfer Fuliza M-Pesa to 254725866107 -,Completed,0,-230.00,-230.00
OCF9S4N725,2020-03-15 17:06:26,OverDraft of Credit Party,Completed,465.54,0,26.00
OCF9S4N725,2020-03-15 17:06:26,Customer Transfer of Funds Charge,Completed,0,-26.00,0.00
OCF9S4N725,2020-03-15 17:06:26,Customer Transfer Fuliza M-Pesa to 254712713212 -,Completed,0,"-1,028.00",-439.54
OCE1RK080L,2020-03-14 19:52:02,Customer Transfer of Funds Charge,Completed,0,-26.00,588.46
OCE1RK080L,2020-03-14 19:52:02,Customer Transfer to 254712843885 - ALFRED,Completed,0,"-1,030.00",614.46
OCE0RARJHA,2020-03-14 15:45:25,Funds received from 254727899306 - BENARD KIPLIMO,Completed,530.00,0,"1,644.46"
OCD9QHWH11,2020-03-13 16:05:36,Pay Bill Online to 244441 - SAFARICOM POSTPAID,Completed,0,-999.00,"1,114.46"
OCC1PORJPL,2020-03-12 16:29:44,Customer Transfer to 254712713212 - FEDELMA,Completed,0,-10.00,"2,113.46"
OCB1OXFXXN,2020-03-11 17:47:47,Business Payment from 400201 - Co-operative Bank via,Completed,"1,500.00",0,"2,123.46"
OCB0OXE67G,2020-03-11 17:46:30,Customer Transfer of Funds Charge,Completed,0,-15.00,623.46
OCB0OXE67G,2020-03-11 17:46:30,Customer Transfer to 254712713212 - FEDELMA,Completed,0,"-1,000.00",638.46
OCB6OQLV2M,2020-03-11 14:07:05,Customer Transfer of Funds Charge,Completed,0,-11.00,"1,638.46"
OCB6OQLV2M,2020-03-11 14:07:05,Customer Transfer to 0718279011 - KIPLANGAT,Completed,0,-327.00,"1,649.46"
OCB2OGUH1E,2020-03-11 08:10:45,Airtime Purchase,Completed,0,-100.00,"1,976.46"
OCB6OG8788,2020-03-11 07:37:29,Airtime Purchase,Completed,0,-100.00,"2,076.46"
OCA1NUQX81,2020-03-10 13:31:12,Pay Bill Online to 244441 - SAFARICOM POSTPAID,Completed,0,-999.00,"2,176.46"
OCA9NUL4U1,2020-03-10 13:25:55,Business Payment from 300318 - TIMIZA. via API,Completed,"2,300.00",0,"3,175.46"
OC90N91TX0,2020-03-09 18:06:28,Airtime Purchase,Completed,0,-50.00,875.46
OC95N2JXH1,2020-03-09 14:39:18,Customer Transfer of Funds Charge,Completed,0,-56.00,925.46
OC95N2JXH1,2020-03-09 14:39:18,Customer Transfer to 254792085136 - caroline ndinda,Completed,0,"-3,050.00",981.46
OC90MW3F5S,2020-03-09 11:02:56,Customer Transfer of Funds Charge,Completed,0,-41.00,"4,031.46"
OC90MW3F5S,2020-03-09 11:02:56,Customer Transfer to 0757603343 - PHILEMON,Completed,0,"-1,528.00","4,072.46"
OC93MUUZH9,2020-03-09 10:21:07,M-Shwari Loan Repayment,Completed,0,"-8,923.00","5,600.46"
OC95MUU53F,2020-03-09 10:20:12,OD Loan Repayment to 232323 - M-PESA Overdraw,Completed,0,-476.54,"14,523.46"
OC93MUU9DT,2020-03-09 10:20:11,Business Payment from 400201 - Co-operative Bank via,Completed,"15,000.00",0,"15,000.00"
OC87LYBMAJ,2020-03-08 07:55:53,OverDraft of Credit Party,Completed,471.82,0,11.00
OC87LYBMAJ,2020-03-08 07:55:53,Customer Transfer of Funds Charge,Completed,0,-11.00,0.00
OC87LYBMAJ,2020-03-08 07:55:53,Customer Transfer Fuliza M-Pesa to 254714905764 -,Completed,0,-500.00,-460.82
OC60KIIIEC,2020-03-06 15:06:00,Pay Bill Charge,Completed,0,-23.00,39.18
OC60KIIIEC,2020-03-06 15:06:00,Pay Bill Online to 964150 - Kenya Medical Training,Completed,0,"-2,022.00",62.18
OC60KI0VZG,2020-03-06 14:50:22,Customer Transfer of Funds Charge,Completed,0,-15.00,"2,084.18"
OC60KI0VZG,2020-03-06 14:50:22,Customer Transfer to 0757603343 - PHILEMON,Completed,0,-527.00,"2,099.18"
OC61KBT78V,2020-03-06 11:25:13,Customer Transfer of Funds Charge,Completed,0,-41.00,"2,626.18"
OC61KBT78V,2020-03-06 11:25:13,Customer Transfer to 254706058836 - JUDY WANJIRU,Completed,0,"-2,228.00","2,667.18"
OC56JMVA04,2020-03-05 15:26:50,Pay Bill Online to 244441 - SAFARICOM POSTPAID,Completed,0,-999.00,"4,895.18"
OC54JM5J7M,2020-03-05 15:03:12,Customer Transfer of Funds Charge,Completed,0,-26.00,"5,894.18"
OC54JM5J7M,2020-03-05 15:03:12,Customer Transfer to 254729629149 - ROBERT KIBET,Completed,0,"-1,028.00","5,920.18"
OC55JKDQ39,2020-03-05 14:04:36,Pay Bill Charge,Completed,0,-23.00,"6,948.18"
OC55JKDQ39,2020-03-05 14:04:36,Pay Bill Online to 888880 - KPLC PREPAID Acc.,Completed,0,-500.00,"6,971.18"
OC50JKBF3M,2020-03-05 14:02:24,Pay Bill Charge,Completed,0,-34.00,"7,471.18"
OC50JKBF3M,2020-03-05 14:02:24,Pay Bill Online to 776611 - JAMII,Completed,0,"-2,000.00","7,505.18"
OC57JJOAWD,2020-03-05 13:41:30,Pay Bill Charge,Completed,0,-85.00,"9,505.18"
OC57JJOAWD,2020-03-05 13:41:30,Pay Bill Online to 712697 - ALDAI GIRLS SECONDARY,Completed,0,"-5,000.00","9,590.18"
OC57JJNHD1,2020-03-05 13:40:43,Business Payment from 400201 - Co-operative Bank via,Completed,"10,000.00",0,"14,590.18"
OC53JCF7LJ,2020-03-05 09:34:36,Airtime Purchase,Completed,0,-100.00,"4,590.18"
OC59JCAM0L,2020-03-05 09:30:02,Airtime Purchase,Completed,0,-100.00,"4,690.18"
OC48IY43S6,2020-03-04 18:19:26,Withdrawal Charge,Completed,0,-84.00,"4,790.18"
OC48IY43S6,2020-03-04 18:19:26,Customer Withdrawal At Agent Till 233409 - Natsars Ltd,Completed,0,"-6,000.00","4,874.18"
OC45IXYNQB,2020-03-04 18:15:54,Business Payment from 400201 - Co-operative Bank via,Completed,"10,000.00",0,"10,874.18"
OC48INB21S,2020-03-04 12:51:56,Customer Transfer of Funds Charge,Completed,0,-97.00,874.18
OC48INB21S,2020-03-04 12:51:56,Customer Transfer to 254720830759 - CHEROTICH K,Completed,0,"-10,112.00",971.18
OC47ILT9V9,2020-03-04 12:00:55,Deposit of Funds at Agent Till 183010 - Peace,Completed,"10,000.00",0,"11,083.18"
OC45IJ44IH,2020-03-04 10:27:26,Customer Transfer of Funds Charge,Completed,0,-77.00,"1,083.18"
OC45IJ44IH,2020-03-04 10:27:26,Customer Transfer to 254728076771 - ESTHER,Completed,0,"-5,067.00","1,160.18"
OC49IJ2WCL,2020-03-04 10:26:24,Customer Transfer to 254708489845 - PURITY JACINTA,Completed,0,-24.00,"6,227.18"
OC44IJ29QU,2020-03-04 10:25:46,Customer Transfer of Funds Charge,Completed,0,-15.00,"6,251.18"
OC44IJ29QU,2020-03-04 10:25:46,Customer Transfer to 254708489845 - PURITY JACINTA,Completed,0,"-1,000.00","6,266.18"
OC47IJ18A1,2020-03-04 10:24:39,Customer Transfer of Funds Charge,Completed,0,-15.00,"7,266.18"
OC47IJ18A1,2020-03-04 10:24:39,Customer Transfer to 254708489845 - PURITY JACINTA,Completed,0,"-1,000.00","7,281.18"
OC48IFMW3I,2020-03-04 08:14:44,Pay Bill Online to 923322 - Safaricom Postpay Bundles,Completed,0,"-1,000.00","8,281.18"
OC36I734AO,2020-03-03 19:53:02,Pay Bill Charge,Completed,0,-45.00,"9,281.18"
OC36I734AO,2020-03-03 19:53:02,Pay Bill Online to 300067 - TIMIZA VIA ABSA Acc. FM-,Completed,0,"-2,546.00","9,326.18"
OC35I6PXVH,2020-03-03 19:45:37,Buy Bundles,Completed,0,"-1,000.00","11,872.18"
OC33I6MSW7,2020-03-03 19:43:58,Pay Bill Charge,Completed,0,-85.00,"12,872.18"
OC33I6MSW7,2020-03-03 19:43:58,Pay Bill Online to 711136 - CIM CREDIT KENYA,Completed,0,"-7,042.00","12,957.18"
OC31I6C0OB,2020-03-03 19:38:07,Customer Transfer of Funds Charge,Completed,0,-26.00,"19,999.18"
OC31I6C0OB,2020-03-03 19:38:07,Customer Transfer to 254723576355 - NOAH KIPTANUI,Completed,0,"-1,028.00","20,025.18"
OC30I63H1U,2020-03-03 19:33:43,Customer Transfer of Funds Charge,Completed,0,-41.00,"21,053.18"
OC30I63H1U,2020-03-03 19:33:43,Customer Transfer to 254724775068 - CALEB,Completed,0,"-2,050.00","21,094.18"
OC33I61ZU3,2020-03-03 19:32:59,Customer Transfer of Funds Charge,Completed,0,-41.00,"23,144.18"
OC33I61ZU3,2020-03-03 19:32:59,Customer Transfer to 254723576355 - NOAH KIPTANUI,Completed,0,"-1,530.00","23,185.18"
OC31I5IFNH,2020-03-03 19:22:55,Customer Transfer of Funds Charge,Completed,0,-15.00,"24,715.18"
OC31I5IFNH,2020-03-03 19:22:55,Customer Transfer to 254718356257 - DAVID KIMUTAI,Completed,0,-527.00,"24,730.18"
OC32I5FX2Y,2020-03-03 19:21:41,Deposit of Funds at Agent Till 233409 - Natsars Ltd,Completed,"25,000.00",0,"25,257.18"
OC34HPN8LA,2020-03-03 11:48:06,Pay Bill Online to 826915 - Safaricom Offers Acc.,Completed,0,-250.00,257.18
OC30HPLKH0,2020-03-03 11:46:34,Airtime Purchase,Completed,0,"-1,000.00",507.18
OC37HPKI9D,2020-03-03 11:45:30,OD Loan Repayment to 232323 - M-PESA Overdraw,Completed,0,"-3,492.82","1,507.18"
OC34HPKE2G,2020-03-03 11:45:29,Business Payment from 400201 - Co-operative Bank via,Completed,"5,000.00",0,"5,000.00"
